fact_id,calendar_id,weather_id,wind_speed_id,temp_id,season_id,total_rentals,casual_rentals,registered_rentals
1,1,1,1,1,1,985,331,654
2,2,2,2,2,2,801,131,670
3,3,3,3,3,3,1349,120,1229
4,4,4,4,4,4,1562,108,1454
5,5,5,5,5,5,1600,82,1518
6,6,6,6,6,6,1606,88,1518
7,7,7,7,7,7,1510,148,1362
8,8,8,8,8,8,959,68,891
9,9,9,9,9,9,822,54,768
10,10,10,10,10,10,1321,41,1280
11,11,11,11,11,11,1263,43,1220
12,12,12,12,12,12,1162,25,1137
13,13,13,13,13,13,1406,38,1368
14,14,14,14,14,14,1421,54,1367
15,15,15,15,15,15,1248,222,1026
16,16,16,16,16,16,1204,251,953
17,17,17,17,17,17,1000,117,883
18,18,18,18,18,18,683,9,674
19,19,19,19,19,19,1650,78,1572
20,20,20,20,20,20,1927,83,1844
21,21,21,21,21,21,1543,75,1468
22,22,22,22,22,22,981,93,888
23,23,23,23,23,23,986,150,836
24,24,24,24,24,24,1416,86,1330
25,25,25,25,25,25,1985,186,1799
26,26,26,26,26,26,506,34,472
27,27,27,27,27,27,431,15,416
28,28,28,28,28,28,1167,38,1129
29,29,29,29,29,29,1098,123,975
30,30,30,30,30,30,1096,140,956
31,31,31,31,31,31,1501,42,1459
32,32,32,32,32,32,1360,47,1313
33,33,33,33,33,33,1526,72,1454
34,34,34,34,34,34,1550,61,1489
35,35,35,35,35,35,1708,88,1620
36,36,36,36,36,36,1005,100,905
37,37,37,37,37,37,1623,354,1269
38,38,38,38,38,38,1712,120,1592
39,39,39,39,39,39,1530,64,1466
40,40,40,40,40,40,1605,53,1552
41,41,41,41,41,41,1538,47,1491
42,42,42,42,42,42,1746,149,1597
43,43,43,43,43,43,1472,288,1184
44,44,44,44,44,44,1589,397,1192
45,45,45,45,45,45,1913,208,1705
46,46,46,46,46,46,1815,140,1675
47,47,47,47,47,47,2115,218,1897
48,48,48,48,48,48,2475,259,2216
49,49,49,49,49,49,2927,579,2348
50,50,50,50,50,50,1635,532,1103
51,51,51,51,51,51,1812,639,1173
52,52,52,52,52,52,1107,195,912
53,53,53,53,53,53,1450,74,1376
54,54,54,54,54,54,1917,139,1778
55,55,55,55,55,55,1807,100,1707
56,56,56,56,56,56,1461,120,1341
57,57,57,57,57,57,1969,424,1545
58,58,58,58,58,58,2402,694,1708
59,59,59,59,59,59,1446,81,1365
60,60,60,60,60,60,1851,137,1714
61,61,61,61,61,61,2134,231,1903
62,62,62,62,62,62,1685,123,1562
63,63,63,63,63,63,1944,214,1730
64,64,64,64,64,64,2077,640,1437
65,65,65,65,65,65,605,114,491
66,66,66,66,66,66,1872,244,1628
67,67,67,67,67,67,2133,316,1817
68,68,68,68,68,68,1891,191,1700
69,69,69,69,69,69,623,46,577
70,70,70,70,70,70,1977,247,1730
71,71,71,71,71,71,2132,724,1408
72,72,72,72,72,72,2417,982,1435
73,73,73,73,73,73,2046,359,1687
74,74,74,74,74,74,2056,289,1767
75,75,75,75,75,75,2192,321,1871
76,76,76,76,76,76,2744,424,2320
77,77,77,77,77,77,3239,884,2355
78,78,78,78,78,78,3117,1424,1693
79,79,79,79,79,79,2471,1047,1424
80,80,80,80,80,80,2077,401,1676
81,81,81,81,81,81,2703,460,2243
82,82,82,82,82,82,2121,203,1918
83,83,83,83,83,83,1865,166,1699
84,84,84,84,84,84,2210,300,1910
85,85,85,85,85,85,2496,981,1515
86,86,86,86,86,86,1693,472,1221
87,87,87,87,87,87,2028,222,1806
88,88,88,88,88,88,2425,317,2108
89,89,89,89,89,89,1536,168,1368
90,90,90,90,90,90,1685,179,1506
91,91,91,91,91,91,2227,307,1920
92,92,92,92,92,92,2252,898,1354
93,93,93,93,93,93,3249,1651,1598
94,94,94,94,94,94,3115,734,2381
95,95,95,95,95,95,1795,167,1628
96,96,96,96,96,96,2808,413,2395
97,97,97,97,97,97,3141,571,2570
98,98,98,98,98,98,1471,172,1299
99,99,99,99,99,99,2455,879,1576
100,100,100,100,100,100,2895,1188,1707
101,101,101,101,101,101,3348,855,2493
102,102,102,102,102,102,2034,257,1777
103,103,103,103,103,103,2162,209,1953
104,104,104,104,104,104,3267,529,2738
105,105,105,105,105,105,3126,642,2484
106,106,106,106,106,106,795,121,674
107,107,107,107,107,107,3744,1558,2186
108,108,108,108,108,108,3429,669,2760
109,109,109,109,109,109,3204,409,2795
110,110,110,110,110,110,3944,613,3331
111,111,111,111,111,111,4189,745,3444
112,112,112,112,112,112,1683,177,1506
113,113,113,113,113,113,4036,1462,2574
114,114,114,114,114,114,4191,1710,2481
115,115,115,115,115,115,4073,773,3300
116,116,116,116,116,116,4400,678,3722
117,117,117,117,117,117,3872,547,3325
118,118,118,118,118,118,4058,569,3489
119,119,119,119,119,119,4595,878,3717
120,120,120,120,120,120,5312,1965,3347
121,121,121,121,121,121,3351,1138,2213
122,122,122,122,122,122,4401,847,3554
123,123,123,123,123,123,4451,603,3848
124,124,124,124,124,124,2633,255,2378
125,125,125,125,125,125,4433,614,3819
126,126,126,126,126,126,4608,894,3714
127,127,127,127,127,127,4714,1612,3102
128,128,128,128,128,128,4333,1401,2932
129,129,129,129,129,129,4362,664,3698
130,130,130,130,130,130,4803,694,4109
131,131,131,131,131,131,4182,550,3632
132,132,132,132,132,132,4864,695,4169
133,133,133,133,133,133,4105,692,3413
134,134,134,134,134,134,3409,902,2507
135,135,135,135,135,135,4553,1582,2971
136,136,136,136,136,136,3958,773,3185
137,137,137,137,137,137,4123,678,3445
138,138,138,138,138,138,3855,536,3319
139,139,139,139,139,139,4575,735,3840
140,140,140,140,140,140,4917,909,4008
141,141,141,141,141,141,5805,2258,3547
142,142,142,142,142,142,4660,1576,3084
143,143,143,143,143,143,4274,836,3438
144,144,144,144,144,144,4492,659,3833
145,145,145,145,145,145,4978,740,4238
146,146,146,146,146,146,4677,758,3919
147,147,147,147,147,147,4679,871,3808
148,148,148,148,148,148,4758,2001,2757
149,149,149,149,149,149,4788,2355,2433
150,150,150,150,150,150,4098,1549,2549
151,151,151,151,151,151,3982,673,3309
152,152,152,152,152,152,3974,513,3461
153,153,153,153,153,153,4968,736,4232
154,154,154,154,154,154,5312,898,4414
155,155,155,155,155,155,5342,1869,3473
156,156,156,156,156,156,4906,1685,3221
157,157,157,157,157,157,4548,673,3875
158,158,158,158,158,158,4833,763,4070
159,159,159,159,159,159,4401,676,3725
160,160,160,160,160,160,3915,563,3352
161,161,161,161,161,161,4586,815,3771
162,162,162,162,162,162,4966,1729,3237
163,163,163,163,163,163,4460,1467,2993
164,164,164,164,164,164,5020,863,4157
165,165,165,165,165,165,4891,727,4164
166,166,166,166,166,166,5180,769,4411
167,167,167,167,167,167,3767,545,3222
168,168,168,168,168,168,4844,863,3981
169,169,169,169,169,169,5119,1807,3312
170,170,170,170,170,170,4744,1639,3105
171,171,171,171,171,171,4010,699,3311
172,172,172,172,172,172,4835,774,4061
173,173,173,173,173,173,4507,661,3846
174,174,174,174,174,174,4790,746,4044
175,175,175,175,175,175,4991,969,4022
176,176,176,176,176,176,5202,1782,3420
177,177,177,177,177,177,5305,1920,3385
178,178,178,178,178,178,4708,854,3854
179,179,179,179,179,179,4648,732,3916
180,180,180,180,180,180,5225,848,4377
181,181,181,181,181,181,5515,1027,4488
182,182,182,182,182,182,5362,1246,4116
183,183,183,183,183,183,5119,2204,2915
184,184,184,184,184,184,4649,2282,2367
185,185,185,185,185,185,6043,3065,2978
186,186,186,186,186,186,4665,1031,3634
187,187,187,187,187,187,4629,784,3845
188,188,188,188,188,188,4592,754,3838
189,189,189,189,189,189,4040,692,3348
190,190,190,190,190,190,5336,1988,3348
191,191,191,191,191,191,4881,1743,3138
192,192,192,192,192,192,4086,723,3363
193,193,193,193,193,193,4258,662,3596
194,194,194,194,194,194,4342,748,3594
195,195,195,195,195,195,5084,888,4196
196,196,196,196,196,196,5538,1318,4220
197,197,197,197,197,197,5923,2418,3505
198,198,198,198,198,198,5302,2006,3296
199,199,199,199,199,199,4458,841,3617
200,200,200,200,200,200,4541,752,3789
201,201,201,201,201,201,4332,644,3688
202,202,202,202,202,202,3784,632,3152
203,203,203,203,203,203,3387,562,2825
204,204,204,204,204,204,3285,987,2298
205,205,205,205,205,205,3606,1050,2556
206,206,206,206,206,206,3840,568,3272
207,207,207,207,207,207,4590,750,3840
208,208,208,208,208,208,4656,755,3901
209,209,209,209,209,209,4390,606,3784
210,210,210,210,210,210,3846,670,3176
211,211,211,211,211,211,4475,1559,2916
212,212,212,212,212,212,4302,1524,2778
213,213,213,213,213,213,4266,729,3537
214,214,214,214,214,214,4845,801,4044
215,215,215,215,215,215,3574,467,3107
216,216,216,216,216,216,4576,799,3777
217,217,217,217,217,217,4866,1023,3843
218,218,218,218,218,218,4294,1521,2773
219,219,219,219,219,219,3785,1298,2487
220,220,220,220,220,220,4326,846,3480
221,221,221,221,221,221,4602,907,3695
222,222,222,222,222,222,4780,884,3896
223,223,223,223,223,223,4792,812,3980
224,224,224,224,224,224,4905,1051,3854
225,225,225,225,225,225,4150,1504,2646
226,226,226,226,226,226,3820,1338,2482
227,227,227,227,227,227,4338,775,3563
228,228,228,228,228,228,4725,721,4004
229,229,229,229,229,229,4694,668,4026
230,230,230,230,230,230,3805,639,3166
231,231,231,231,231,231,4153,797,3356
232,232,232,232,232,232,5191,1914,3277
233,233,233,233,233,233,3873,1249,2624
234,234,234,234,234,234,4758,833,3925
235,235,235,235,235,235,5895,1281,4614
236,236,236,236,236,236,5130,949,4181
237,237,237,237,237,237,3542,435,3107
238,238,238,238,238,238,4661,768,3893
239,239,239,239,239,239,1115,226,889
240,240,240,240,240,240,4334,1415,2919
241,241,241,241,241,241,4634,729,3905
242,242,242,242,242,242,5204,775,4429
243,243,243,243,243,243,5058,688,4370
244,244,244,244,244,244,5115,783,4332
245,245,245,245,245,245,4727,875,3852
246,246,246,246,246,246,4484,1935,2549
247,247,247,247,247,247,4940,2521,2419
248,248,248,248,248,248,3351,1236,2115
249,249,249,249,249,249,2710,204,2506
250,250,250,250,250,250,1996,118,1878
251,251,251,251,251,251,1842,153,1689
252,252,252,252,252,252,3544,417,3127
253,253,253,253,253,253,5345,1750,3595
254,254,254,254,254,254,5046,1633,3413
255,255,255,255,255,255,4713,690,4023
256,256,256,256,256,256,4763,701,4062
257,257,257,257,257,257,4785,647,4138
258,258,258,258,258,258,3659,428,3231
259,259,259,259,259,259,4760,742,4018
260,260,260,260,260,260,4511,1434,3077
261,261,261,261,261,261,4274,1353,2921
262,262,262,262,262,262,4539,691,3848
263,263,263,263,263,263,3641,438,3203
264,264,264,264,264,264,4352,539,3813
265,265,265,265,265,265,4795,555,4240
266,266,266,266,266,266,2395,258,2137
267,267,267,267,267,267,5423,1776,3647
268,268,268,268,268,268,5010,1544,3466
269,269,269,269,269,269,4630,684,3946
270,270,270,270,270,270,4120,477,3643
271,271,271,271,271,271,3907,480,3427
272,272,272,272,272,272,4839,653,4186
273,273,273,273,273,273,5202,830,4372
274,274,274,274,274,274,2429,480,1949
275,275,275,275,275,275,2918,616,2302
276,276,276,276,276,276,3570,330,3240
277,277,277,277,277,277,4456,486,3970
278,278,278,278,278,278,4826,559,4267
279,279,279,279,279,279,4765,639,4126
280,280,280,280,280,280,4985,949,4036
281,281,281,281,281,281,5409,2235,3174
282,282,282,282,282,282,5511,2397,3114
283,283,283,283,283,283,5117,1514,3603
284,284,284,284,284,284,4563,667,3896
285,285,285,285,285,285,2416,217,2199
286,286,286,286,286,286,2913,290,2623
287,287,287,287,287,287,3644,529,3115
288,288,288,288,288,288,5217,1899,3318
289,289,289,289,289,289,5041,1748,3293
290,290,290,290,290,290,4570,713,3857
291,291,291,291,291,291,4748,637,4111
292,292,292,292,292,292,2424,254,2170
293,293,293,293,293,293,4195,471,3724
294,294,294,294,294,294,4304,676,3628
295,295,295,295,295,295,4308,1499,2809
296,296,296,296,296,296,4381,1619,2762
297,297,297,297,297,297,4187,699,3488
298,298,298,298,298,298,4687,695,3992
299,299,299,299,299,299,3894,404,3490
300,300,300,300,300,300,2659,240,2419
301,301,301,301,301,301,3747,456,3291
302,302,302,302,302,302,627,57,570
303,303,303,303,303,303,3331,885,2446
304,304,304,304,304,304,3669,362,3307
305,305,305,305,305,305,4068,410,3658
306,306,306,306,306,306,4186,370,3816
307,307,307,307,307,307,3974,318,3656
308,308,308,308,308,308,4046,470,3576
309,309,309,309,309,309,3926,1156,2770
310,310,310,310,310,310,3649,952,2697
311,311,311,311,311,311,4035,373,3662
312,312,312,312,312,312,4205,376,3829
313,313,313,313,313,313,4109,305,3804
314,314,314,314,314,314,2933,190,2743
315,315,315,315,315,315,3368,440,2928
316,316,316,316,316,316,4067,1275,2792
317,317,317,317,317,317,3717,1004,2713
318,318,318,318,318,318,4486,595,3891
319,319,319,319,319,319,4195,449,3746
320,320,320,320,320,320,1817,145,1672
321,321,321,321,321,321,3053,139,2914
322,322,322,322,322,322,3392,245,3147
323,323,323,323,323,323,3663,943,2720
324,324,324,324,324,324,3520,787,2733
325,325,325,325,325,325,2765,220,2545
326,326,326,326,326,326,1607,69,1538
327,327,327,327,327,327,2566,112,2454
328,328,328,328,328,328,1495,560,935
329,329,329,329,329,329,2792,1095,1697
330,330,330,330,330,330,3068,1249,1819
331,331,331,331,331,331,3071,810,2261
332,332,332,332,332,332,3867,253,3614
333,333,333,333,333,333,2914,96,2818
334,334,334,334,334,334,3613,188,3425
335,335,335,335,335,335,3727,182,3545
336,336,336,336,336,336,3940,268,3672
337,337,337,337,337,337,3614,706,2908
338,338,338,338,338,338,3485,634,2851
339,339,339,339,339,339,3811,233,3578
340,340,340,340,340,340,2594,126,2468
341,341,341,341,341,341,705,50,655
342,342,342,342,342,342,3322,150,3172
343,343,343,343,343,343,3620,261,3359
344,344,344,344,344,344,3190,502,2688
345,345,345,345,345,345,2743,377,2366
346,346,346,346,346,346,3310,143,3167
347,347,347,347,347,347,3523,155,3368
348,348,348,348,348,348,3740,178,3562
349,349,349,349,349,349,3709,181,3528
350,350,350,350,350,350,3577,178,3399
351,351,351,351,351,351,2739,275,2464
352,352,352,352,352,352,2431,220,2211
353,353,353,353,353,353,3403,260,3143
354,354,354,354,354,354,3750,216,3534
355,355,355,355,355,355,2660,107,2553
356,356,356,356,356,356,3068,227,2841
357,357,357,357,357,357,2209,163,2046
358,358,358,358,358,358,1011,155,856
359,359,359,359,359,359,754,303,451
360,360,360,360,360,360,1317,430,887
361,361,361,361,361,361,1162,103,1059
362,362,362,362,362,362,2302,255,2047
363,363,363,363,363,363,2423,254,2169
364,364,364,364,364,364,2999,491,2508
365,365,365,365,365,365,2485,665,1820
366,366,366,366,366,366,2294,686,1608
367,367,367,367,367,367,1951,244,1707
368,368,368,368,368,368,2236,89,2147
369,369,369,369,369,369,2368,95,2273
370,370,370,370,370,370,3272,140,3132
371,371,371,371,371,371,4098,307,3791
372,372,372,372,372,372,4521,1070,3451
373,373,373,373,373,373,3425,599,2826
374,374,374,374,374,374,2376,106,2270
375,375,375,375,375,375,3598,173,3425
376,376,376,376,376,376,2177,92,2085
377,377,377,377,377,377,4097,269,3828
378,378,378,378,378,378,3214,174,3040
379,379,379,379,379,379,2493,333,2160
380,380,380,380,380,380,2311,284,2027
381,381,381,381,381,381,2298,217,2081
382,382,382,382,382,382,2935,127,2808
383,383,383,383,383,383,3376,109,3267
384,384,384,384,384,384,3292,130,3162
385,385,385,385,385,385,3163,115,3048
386,386,386,386,386,386,1301,67,1234
387,387,387,387,387,387,1977,196,1781
388,388,388,388,388,388,2432,145,2287
389,389,389,389,389,389,4339,439,3900
390,390,390,390,390,390,4270,467,3803
391,391,391,391,391,391,4075,244,3831
392,392,392,392,392,392,3456,269,3187
393,393,393,393,393,393,4023,775,3248
394,394,394,394,394,394,3243,558,2685
395,395,395,395,395,395,3624,126,3498
396,396,396,396,396,396,4509,324,4185
397,397,397,397,397,397,4579,304,4275
398,398,398,398,398,398,3761,190,3571
399,399,399,399,399,399,4151,310,3841
400,400,400,400,400,400,2832,384,2448
401,401,401,401,401,401,2947,318,2629
402,402,402,402,402,402,3784,206,3578
403,403,403,403,403,403,4375,199,4176
404,404,404,404,404,404,2802,109,2693
405,405,405,405,405,405,3830,163,3667
406,406,406,406,406,406,3831,227,3604
407,407,407,407,407,407,2169,192,1977
408,408,408,408,408,408,1529,73,1456
409,409,409,409,409,409,3422,94,3328
410,410,410,410,410,410,3922,135,3787
411,411,411,411,411,411,4169,141,4028
412,412,412,412,412,412,3005,74,2931
413,413,413,413,413,413,4154,349,3805
414,414,414,414,414,414,4318,1435,2883
415,415,415,415,415,415,2689,618,2071
416,416,416,416,416,416,3129,502,2627
417,417,417,417,417,417,3777,163,3614
418,418,418,418,418,418,4773,394,4379
419,419,419,419,419,419,5062,516,4546
420,420,420,420,420,420,3487,246,3241
421,421,421,421,421,421,2732,317,2415
422,422,422,422,422,422,3389,515,2874
423,423,423,423,423,423,4322,253,4069
424,424,424,424,424,424,4363,229,4134
425,425,425,425,425,425,1834,65,1769
426,426,426,426,426,426,4990,325,4665
427,427,427,427,427,427,3194,246,2948
428,428,428,428,428,428,4066,956,3110
429,429,429,429,429,429,3423,710,2713
430,430,430,430,430,430,3333,203,3130
431,431,431,431,431,431,3956,221,3735
432,432,432,432,432,432,4916,432,4484
433,433,433,433,433,433,5382,486,4896
434,434,434,434,434,434,4569,447,4122
435,435,435,435,435,435,4118,968,3150
436,436,436,436,436,436,4911,1658,3253
437,437,437,437,437,437,5298,838,4460
438,438,438,438,438,438,5847,762,5085
439,439,439,439,439,439,6312,997,5315
440,440,440,440,440,440,6192,1005,5187
441,441,441,441,441,441,4378,548,3830
442,442,442,442,442,442,7836,3155,4681
443,443,443,443,443,443,5892,2207,3685
444,444,444,444,444,444,6153,982,5171
445,445,445,445,445,445,6093,1051,5042
446,446,446,446,446,446,6230,1122,5108
447,447,447,447,447,447,6871,1334,5537
448,448,448,448,448,448,8362,2469,5893
449,449,449,449,449,449,3372,1033,2339
450,450,450,450,450,450,4996,1532,3464
451,451,451,451,451,451,5558,795,4763
452,452,452,452,452,452,5102,531,4571
453,453,453,453,453,453,5698,674,5024
454,454,454,454,454,454,6133,834,5299
455,455,455,455,455,455,5459,796,4663
456,456,456,456,456,456,6235,2301,3934
457,457,457,457,457,457,6041,2347,3694
458,458,458,458,458,458,5936,1208,4728
459,459,459,459,459,459,6772,1348,5424
460,460,460,460,460,460,6436,1058,5378
461,461,461,461,461,461,6457,1192,5265
462,462,462,462,462,462,6460,1807,4653
463,463,463,463,463,463,6857,3252,3605
464,464,464,464,464,464,5169,2230,2939
465,465,465,465,465,465,5585,905,4680
466,466,466,466,466,466,5918,819,5099
467,467,467,467,467,467,4862,482,4380
468,468,468,468,468,468,5409,663,4746
469,469,469,469,469,469,6398,1252,5146
470,470,470,470,470,470,7460,2795,4665
471,471,471,471,471,471,7132,2846,4286
472,472,472,472,472,472,6370,1198,5172
473,473,473,473,473,473,6691,989,5702
474,474,474,474,474,474,4367,347,4020
475,475,475,475,475,475,6565,846,5719
476,476,476,476,476,476,7290,1340,5950
477,477,477,477,477,477,6624,2541,4083
478,478,478,478,478,478,1027,120,907
479,479,479,479,479,479,3214,195,3019
480,480,480,480,480,480,5633,518,5115
481,481,481,481,481,481,6196,655,5541
482,482,482,482,482,482,5026,475,4551
483,483,483,483,483,483,6233,1014,5219
484,484,484,484,484,484,4220,1120,3100
485,485,485,485,485,485,6304,2229,4075
486,486,486,486,486,486,5572,665,4907
487,487,487,487,487,487,5740,653,5087
488,488,488,488,488,488,6169,667,5502
489,489,489,489,489,489,6421,764,5657
490,490,490,490,490,490,6296,1069,5227
491,491,491,491,491,491,6883,2496,4387
492,492,492,492,492,492,6359,2135,4224
493,493,493,493,493,493,6273,1008,5265
494,494,494,494,494,494,5728,738,4990
495,495,495,495,495,495,4717,620,4097
496,496,496,496,496,496,6572,1026,5546
497,497,497,497,497,497,7030,1319,5711
498,498,498,498,498,498,7429,2622,4807
499,499,499,499,499,499,6118,2172,3946
500,500,500,500,500,500,2843,342,2501
501,501,501,501,501,501,5115,625,4490
502,502,502,502,502,502,7424,991,6433
503,503,503,503,503,503,7384,1242,6142
504,504,504,504,504,504,7639,1521,6118
505,505,505,505,505,505,8294,3410,4884
506,506,506,506,506,506,7129,2704,4425
507,507,507,507,507,507,4359,630,3729
508,508,508,508,508,508,6073,819,5254
509,509,509,509,509,509,5260,766,4494
510,510,510,510,510,510,6770,1059,5711
511,511,511,511,511,511,6734,1417,5317
512,512,512,512,512,512,6536,2855,3681
513,513,513,513,513,513,6591,3283,3308
514,514,514,514,514,514,6043,2557,3486
515,515,515,515,515,515,5743,880,4863
516,516,516,516,516,516,6855,745,6110
517,517,517,517,517,517,7338,1100,6238
518,518,518,518,518,518,4127,533,3594
519,519,519,519,519,519,8120,2795,5325
520,520,520,520,520,520,7641,2494,5147
521,521,521,521,521,521,6998,1071,5927
522,522,522,522,522,522,7001,968,6033
523,523,523,523,523,523,7055,1027,6028
524,524,524,524,524,524,7494,1038,6456
525,525,525,525,525,525,7736,1488,6248
526,526,526,526,526,526,7498,2708,4790
527,527,527,527,527,527,6598,2224,4374
528,528,528,528,528,528,6664,1017,5647
529,529,529,529,529,529,4972,477,4495
530,530,530,530,530,530,7421,1173,6248
531,531,531,531,531,531,7363,1180,6183
532,532,532,532,532,532,7665,1563,6102
533,533,533,533,533,533,7702,2963,4739
534,534,534,534,534,534,6978,2634,4344
535,535,535,535,535,535,5099,653,4446
536,536,536,536,536,536,6825,968,5857
537,537,537,537,537,537,6211,872,5339
538,538,538,538,538,538,5905,778,5127
539,539,539,539,539,539,5823,964,4859
540,540,540,540,540,540,7458,2657,4801
541,541,541,541,541,541,6891,2551,4340
542,542,542,542,542,542,6779,1139,5640
543,543,543,543,543,543,7442,1077,6365
544,544,544,544,544,544,7335,1077,6258
545,545,545,545,545,545,6879,921,5958
546,546,546,546,546,546,5463,829,4634
547,547,547,547,547,547,5687,1455,4232
548,548,548,548,548,548,5531,1421,4110
549,549,549,549,549,549,6227,904,5323
550,550,550,550,550,550,6660,1052,5608
551,551,551,551,551,551,7403,2562,4841
552,552,552,552,552,552,6241,1405,4836
553,553,553,553,553,553,6207,1366,4841
554,554,554,554,554,554,4840,1448,3392
555,555,555,555,555,555,4672,1203,3469
556,556,556,556,556,556,6569,998,5571
557,557,557,557,557,557,6290,954,5336
558,558,558,558,558,558,7264,975,6289
559,559,559,559,559,559,7446,1032,6414
560,560,560,560,560,560,7499,1511,5988
561,561,561,561,561,561,6969,2355,4614
562,562,562,562,562,562,6031,1920,4111
563,563,563,563,563,563,6830,1088,5742
564,564,564,564,564,564,6786,921,5865
565,565,565,565,565,565,5713,799,4914
566,566,566,566,566,566,6591,888,5703
567,567,567,567,567,567,5870,747,5123
568,568,568,568,568,568,4459,1264,3195
569,569,569,569,569,569,7410,2544,4866
570,570,570,570,570,570,6966,1135,5831
571,571,571,571,571,571,7592,1140,6452
572,572,572,572,572,572,8173,1383,6790
573,573,573,573,573,573,6861,1036,5825
574,574,574,574,574,574,6904,1259,5645
575,575,575,575,575,575,6685,2234,4451
576,576,576,576,576,576,6597,2153,4444
577,577,577,577,577,577,7105,1040,6065
578,578,578,578,578,578,7216,968,6248
579,579,579,579,579,579,7580,1074,6506
580,580,580,580,580,580,7261,983,6278
581,581,581,581,581,581,7175,1328,5847
582,582,582,582,582,582,6824,2345,4479
583,583,583,583,583,583,5464,1707,3757
584,584,584,584,584,584,7013,1233,5780
585,585,585,585,585,585,7273,1278,5995
586,586,586,586,586,586,7534,1263,6271
587,587,587,587,587,587,7286,1196,6090
588,588,588,588,588,588,5786,1065,4721
589,589,589,589,589,589,6299,2247,4052
590,590,590,590,590,590,6544,2182,4362
591,591,591,591,591,591,6883,1207,5676
592,592,592,592,592,592,6784,1128,5656
593,593,593,593,593,593,7347,1198,6149
594,594,594,594,594,594,7605,1338,6267
595,595,595,595,595,595,7148,1483,5665
596,596,596,596,596,596,7865,2827,5038
597,597,597,597,597,597,4549,1208,3341
598,598,598,598,598,598,6530,1026,5504
599,599,599,599,599,599,7006,1081,5925
600,600,600,600,600,600,7375,1094,6281
601,601,601,601,601,601,7765,1363,6402
602,602,602,602,602,602,7582,1325,6257
603,603,603,603,603,603,6053,1829,4224
604,604,604,604,604,604,5255,1483,3772
605,605,605,605,605,605,6917,989,5928
606,606,606,606,606,606,7040,935,6105
607,607,607,607,607,607,7697,1177,6520
608,608,608,608,608,608,7713,1172,6541
609,609,609,609,609,609,7350,1433,5917
610,610,610,610,610,610,6140,2352,3788
611,611,611,611,611,611,5810,2613,3197
612,612,612,612,612,612,6034,1965,4069
613,613,613,613,613,613,6864,867,5997
614,614,614,614,614,614,7112,832,6280
615,615,615,615,615,615,6203,611,5592
616,616,616,616,616,616,7504,1045,6459
617,617,617,617,617,617,5976,1557,4419
618,618,618,618,618,618,8227,2570,5657
619,619,619,619,619,619,7525,1118,6407
620,620,620,620,620,620,7767,1070,6697
621,621,621,621,621,621,7870,1050,6820
622,622,622,622,622,622,7804,1054,6750
623,623,623,623,623,623,8009,1379,6630
624,624,624,624,624,624,8714,3160,5554
625,625,625,625,625,625,7333,2166,5167
626,626,626,626,626,626,6869,1022,5847
627,627,627,627,627,627,4073,371,3702
628,628,628,628,628,628,7591,788,6803
629,629,629,629,629,629,7720,939,6781
630,630,630,630,630,630,8167,1250,6917
631,631,631,631,631,631,8395,2512,5883
632,632,632,632,632,632,7907,2454,5453
633,633,633,633,633,633,7436,1001,6435
634,634,634,634,634,634,7538,845,6693
635,635,635,635,635,635,7733,787,6946
636,636,636,636,636,636,7393,751,6642
637,637,637,637,637,637,7415,1045,6370
638,638,638,638,638,638,8555,2589,5966
639,639,639,639,639,639,6889,2015,4874
640,640,640,640,640,640,6778,763,6015
641,641,641,641,641,641,4639,315,4324
642,642,642,642,642,642,7572,728,6844
643,643,643,643,643,643,7328,891,6437
644,644,644,644,644,644,8156,1516,6640
645,645,645,645,645,645,7965,3031,4934
646,646,646,646,646,646,3510,781,2729
647,647,647,647,647,647,5478,874,4604
648,648,648,648,648,648,6392,601,5791
649,649,649,649,649,649,7691,780,6911
650,650,650,650,650,650,7570,834,6736
651,651,651,651,651,651,7282,1060,6222
652,652,652,652,652,652,7109,2252,4857
653,653,653,653,653,653,6639,2080,4559
654,654,654,654,654,654,5875,760,5115
655,655,655,655,655,655,7534,922,6612
656,656,656,656,656,656,7461,979,6482
657,657,657,657,657,657,7509,1008,6501
658,658,658,658,658,658,5424,753,4671
659,659,659,659,659,659,8090,2806,5284
660,660,660,660,660,660,6824,2132,4692
661,661,661,661,661,661,7058,830,6228
662,662,662,662,662,662,7466,841,6625
663,663,663,663,663,663,7693,795,6898
664,664,664,664,664,664,7359,875,6484
665,665,665,665,665,665,7444,1182,6262
666,666,666,666,666,666,7852,2643,5209
667,667,667,667,667,667,4459,998,3461
668,668,668,668,668,668,22,2,20
669,669,669,669,669,669,1096,87,1009
670,670,670,670,670,670,5566,419,5147
671,671,671,671,671,671,5986,466,5520
672,672,672,672,672,672,5847,618,5229
673,673,673,673,673,673,5138,1029,4109
674,674,674,674,674,674,5107,1201,3906
675,675,675,675,675,675,5259,378,4881
676,676,676,676,676,676,5686,466,5220
677,677,677,677,677,677,5035,326,4709
678,678,678,678,678,678,5315,340,4975
679,679,679,679,679,679,5992,709,5283
680,680,680,680,680,680,6536,2090,4446
681,681,681,681,681,681,6852,2290,4562
682,682,682,682,682,682,6269,1097,5172
683,683,683,683,683,683,4094,327,3767
684,684,684,684,684,684,5495,373,5122
685,685,685,685,685,685,5445,320,5125
686,686,686,686,686,686,5698,484,5214
687,687,687,687,687,687,5629,1313,4316
688,688,688,688,688,688,4669,922,3747
689,689,689,689,689,689,5499,449,5050
690,690,690,690,690,690,5634,534,5100
691,691,691,691,691,691,5146,615,4531
692,692,692,692,692,692,2425,955,1470
693,693,693,693,693,693,3910,1603,2307
694,694,694,694,694,694,2277,532,1745
695,695,695,695,695,695,2424,309,2115
696,696,696,696,696,696,5087,337,4750
697,697,697,697,697,697,3959,123,3836
698,698,698,698,698,698,5260,198,5062
699,699,699,699,699,699,5323,243,5080
700,700,700,700,700,700,5668,362,5306
701,701,701,701,701,701,5191,951,4240
702,702,702,702,702,702,4649,892,3757
703,703,703,703,703,703,6234,555,5679
704,704,704,704,704,704,6606,551,6055
705,705,705,705,705,705,5729,331,5398
706,706,706,706,706,706,5375,340,5035
707,707,707,707,707,707,5008,349,4659
708,708,708,708,708,708,5582,1153,4429
709,709,709,709,709,709,3228,441,2787
710,710,710,710,710,710,5170,329,4841
711,711,711,711,711,711,5501,282,5219
712,712,712,712,712,712,5319,310,5009
713,713,713,713,713,713,5532,425,5107
714,714,714,714,714,714,5611,429,5182
715,715,715,715,715,715,5047,767,4280
716,716,716,716,716,716,3786,538,3248
717,717,717,717,717,717,4585,212,4373
718,718,718,718,718,718,5557,433,5124
719,719,719,719,719,719,5267,333,4934
720,720,720,720,720,720,4128,314,3814
721,721,721,721,721,721,3623,221,3402
722,722,722,722,722,722,1749,205,1544
723,723,723,723,723,723,1787,408,1379
724,724,724,724,724,724,920,174,746
725,725,725,725,725,725,1013,440,573
726,726,726,726,726,726,441,9,432
727,727,727,727,727,727,2114,247,1867
728,728,728,728,728,728,3095,644,2451
729,729,729,729,729,729,1341,159,1182
730,730,730,730,730,730,1796,364,1432
731,731,731,731,731,731,2729,439,2290
